#########
#000000.#
#00000###
#$#0#0###
#$00#####
#@00$0###
#000000##
#.000$0##
#########