0######00
##000###0
##.0000##
##00$#0@#
###00.00#
#000$000#
##00#000#
#000#####
#####0000