#########
#.00000.#
#00000###
#0#$#0###
#000#####
#@00$0###
#000000##
#.000$0##
#########