#########
#000000.#
#00000###
#0#0#0###
#000#####
#M00$0###
#000000##
#M@0000##
#########
