#########
#000000.#
#00000###
#0#0#0###
#$00#####
#.00$0###
#0000@0##
#000000##
#########
