#########
#000000.#
#00000###
#0#0#0###
#000#####
#@00$0###
#000000##
#M000$0##
#########
